11111111
11111P11
11111111
111C1111
11111111

colectables 2
target colatebles  3

number of exits 1
targe number of