11111111111111
100C0000000001
100C0111111101
100CP0E0000001
11111111111111