1111111111111
100C00C0000C1
1C00011111111
1P0000E000001
1111111111111