1111111111111
100000C0000C1
1C00001111111
1P0000EC00001
1000001000001
1111111111111