1111111111111111111111111111111111111111
1E1110000000000C00000C000000000100010001
1011110100100000101001000000010101000101
1010010010101010001001000000010101011001
100011111C00C0000111111100000000C1010001
1001111111111100C00000000C00000001010111
10000C0000C000000000C00000000C00010100P1
100001111111110C0001111110C0000001111111
1000000C0000111111C111111110C00001000001
1C000C0000000C00011111C00000000000000001
1000000000C11111111111000000000000000001
1000000000000000C00000000C00000000000001
1111111111111111111111111111111111111111